20 10 -10 -5
1	1	1	1	1	1	1	1	1	1	1	1	1	1		1	1	1	1	1	1
1	0	0	0	0	0	0	0	0	0	0	0	0	1000	0	0	0	0	0	1
1	0	0	0	0	0	0	0	0	0	0	0	0	0		0	0	0	0	0	1
1	0	0	0	0	204	204	204	0	0	0	0	0	0		0	0	0	0	0	1
1	0	0	304	0	0	0	0	0	104	0	0	0	0		0	0	0	0	0	1
1	0	0	304	0	0	0	0	0	104	0	0	0	0		0	0	0	0	0	1
1	0	0	304	0	0	0	0	0	104	0	0	0	0		0	0	0	0	0	1
1	0	0	304	0	0	0	0	0	0	0	404	404	404		404	0	0	0	0	1
1	0	0	0	0	0	0	0	0	0	0	0	0	0		0	0	0	0	0	1
1	1	1	1	1	1	1	1	1	2	2	2	1	1		1	1	1	1	1	1